1111234111
1        1
1   55   2
1     44 1
1 411    1
1 4     41
1   4    1
1555    11
1    11  1
1123411311