1111234111
1      2 1
1  222   2
1  1  3332
1   1    3
1    1  41
1       11
1 555   11
1     11 1
1123411311